team (with): 充满，到处都是
(be) poise: 使准备好
ennui: 无聊;倦怠
subscribe (to): 同意，赞同
sober: 严肃的;庄重的;冷静的
somber: 阴郁的，阴沉的，严肃的
accession: (正式的)同意
sleek: 线条明快的，造型优美的
guileless: 老实的;单纯的
mandate: 命令，强求
(be) temper (with): 减弱，限制，缓和
temperate: 有节制的，有自制力的
itinerant: 巡回的，巡游的
phlegmatic: 冷漠的，冷静的，感情迟钝的
prognosis: 预言，预测
muddle: 混乱，混乱的东西
moralize: 讲道德，说教
moralistic: 喜欢说教的，喜欢从道德上评判他人的
leach: 被溶滤;被滤掉
unparalleled: 无比的;无双的;独一无二的
dispel: 打消，消除(想法、情绪等)
ameliorate: 改善;缓解;减轻
concomitant: 伴随出现的情况
vapid: 枯燥的，乏味的
churlish: 粗暴的;无礼的;脾气坏的
aberrant: 偏离常轨的;反常的，异常的
aberration: 异常，异常的事物
totem: 图腾，象征物;崇拜物
totemic: 图腾般的，有象征意义的
engender: 带来，产生，导致
tyro: 初学者，新手;生手
formulate: 发明，规划，制定(策略、计划等)
foreground: 突出，强调
momentous: 重大的，重要的
wholesale: 大批的;大规模的;不分青红皂白的
correspondence: [总称] 信件
vindication: 证明......合理; 证明......无罪
discrete: 分离的，互不相连的;不相关联的
discreet: 言行)谨慎的，慎重的
discretion: 谨慎;慎重; 自主权，自行作决定的自由
indiscretion: 不谨慎的言行，鲁莽的言行
lapse: 小错，失误，差错
formidable: 难以克服的，难对付的
parochial: 眼光狭隘的
diminutive: 极小的
imperil: 使陷于危险，危及
flippant: 轻浮的，不严肃的，不敬的
petulant: 脾气坏的
umbrage: 生气，不愉快
bleak: 没有希望的;凄凉的;阴郁的
complement: 补充，补足
compliment: 恭维，称赞
competence: 能力;胜任，称职
valediction: 告别;告别辞
amalgam: 混合物
boisterous: 喧闹的;活蹦乱跳的
snob: 对地位高于自己者极力攀附、对地位低于自己者冷落蔑视的人，势利眼
vociferous: 大声疾呼的，(表达观点时)大吵大嚷的
impassioned: 充满激情的;激昂的;热烈的
connoisseur: (尤指艺术等方面的)行家，鉴赏家)
patron: (艺术家、作家等的)资助人;赞助人
patronizing: 傲慢的，自认为高人一等的
modicum: 少量，一点点
revel (in): 享受，陶醉于，纵情于
numinous: 超自然的，神秘的
chronology: 大事年表; 年代顺序，时间顺序
sensational: 引起轰动的
cliché: 陈词滥调
antediluvian: 极为落伍的，老掉牙的
hard-and-fast: 明确的，不容改变的
trendy: 时髦的;赶时髦的
anachronistic: (戏剧、电影等)时代错误的; 不合时代的，过时的，落伍的
anachronism: 不合时代的事物;过时的事物
theatrics: 夸张的言行;演戏一样的举止;矫揉造作的姿态
far-fetched: (故事、想法)牵强的，不可信的
restive, restless: 焦躁不安的;不耐烦的
