emerge: (从困境中)幸存下来，恢复过来
emergent: 刚出现的，刚兴起的
perplex: 使困惑，使茫然;使费解
nuance: (意思、颜色等的)细微差别
finicky: 过分讲究的;挑剔的，难讨好的
valorize: 肯定，认可
circuitous: 迂回的，曲折的
conciliatory: 安抚的，和解的
chagrin: 懊恼，恼怒;苦恼
anecdote: 道听途说，(不可靠的)传闻
terrain: 地形，土地
terrestrial: 陆生的;长在土壤里的;陆栖的
extraterrestrial: 地球外的;行星际的;宇宙的
sluggish: 缓慢的，慢的
proliferate: 激增;扩散
congenial: 志趣相投的，合得来的
startling: 惊人的
interdisciplinary: 跨学科的
undisciplined: 不遵守纪律的;不服从命令的
gainsay: 反驳;反对
strenuous: 艰苦的;繁重的
upkeep: (设备等的)保养，维护
precipitate: 鲁莽的;草率的
protracted: 延长的，拖延的
malfeasance: (尤指公务人员的)违法行为;渎职
misfeasance: 违法行为
minuscule: 非常小的，极小的
disinterested: 客观的，公正的，无私的
abstemious: (饮食等)有节制的
precede: (顺序、位置或时间上)处在...之前，先于...出现
chimera: 幻想的事物，不可能的事物
inflammatory: 使人激愤的;煽动性的
laconic: 惜字如金的，用词极为简短的
strike: 给人以......的印象; 罢工
be struck by/with: 对......感到震撼，对......感到惊奇，对......赞叹不已
archaic: 极为过时的，极为落伍的
recollection: 回忆，记忆;记忆力
sever: 切断，断开(联系、关系等)
cur: 劣等狗;杂种狗;恶狗
acrimony: (语言、争吵等的)尖刻;激烈
cutting: (言论等)伤人感情的;挖苦的;尖刻的
pristine: 未触动过的;未受破坏的;崭新的
taciturn: 沉默寡言的，不爱说话的
effluvium: 气味(尤指臭气);恶臭
resign: 使接受(不喜欢却无法避免的东西)，使面对现实
deify: 神化;把...奉若神明
meager: (数量或质量)缺乏的，不足的
onerous: (任务、责任等)艰巨的;繁重的;麻烦的
disgorge: 吐出
venture: 有风险的商业活动; 敢于，冒险去
plaintive: (声音)悲伤的，哀怨的
redolent: 有强烈气味的
disseminate: 散布(信息等);传播
hard-boiled: 强硬的，不为所动的
capricious: 反复无常的，容易头脑发热的
veneration: 极为尊敬
obdurate: 固执的，顽固不化的
latent: 潜在的，隐伏的，不易察觉的
lyrical: 富有诗意的
spew: 喷涌，喷射
considerably: 相当大地;在很大程度上
brackish: 味道不好的;令人不快的;使人恶心的
trove: 宝库
circumstantial: 环境导致的;视情况而定的
perfidious: 背信弃义的，不忠实的
serendipity: 意外发现有益的事物;机缘巧合
forbear: 忍住(不去做某事)，克制
tract: (土地等的)大片;一大片土地
