in the course of: 在......期间
pitfall: 隐藏的危险，隐患，陷阱
jibe: 嘲讽，嘲笑
gleam: 闪烁;发微光
felicitous: (措辞等)恰当的，贴切的
cliquish: 小集团的，小集团似的
elusive: 难以捕捉的，难以得到的; 难以定义的，难以理解的
conjure up: 使想到，使想起，使感受到
prolix: 冗长的，啰嗦的
invigorate: 使有活力
let alone: 更不必说
candor: 坦率;坦诚;真诚
candid: 坦率的;直言不讳的
ogre: 可怕的人，残酷的人;可怕的东西
spirited: 精神饱满的，生气勃勃的
culpability: 有罪，对过错负有责任
all the more: 越发，更加，格外
detached: 分离的，独立的; 不带个人感情的;公正的;超然的
quirky: 古怪的
allege: 断言;声称;(证据不足地)指责
vilify: 污蔑，诋毁，中伤
captious: 吹毛求疵的
beneficence: 善良，行善
foster: 促进，鼓励，助长
immaterial: 不重要的，无关紧要的
deter: 威慑住，吓住
thrift: 节约，节俭
exact: 要求，强取，勒索
exacting: 困难的，艰难的，要求高的
condemnation: 谴责
plot: 一小片土地
voracious: 贪吃的，狼吞虎咽的; 如饥似渴的，极为热情的
jockey: (娴熟或狡猾地)操作，操纵
peril: 巨大的危险
rebuff: 断然拒绝;回绝;冷落
devious: 阴险的，狡猾的，不诚实的
conjecture: 推测，猜测
cavalier: 漫不经心的，满不在乎的
appraise: 评价，评估
spartan: 极为简朴的
capitulate: 投降;停止抵抗
proclaim: 宣告，宣布;声明
exceptional: 异常的，独特的，非典型的
enliven: 使有生气，使活跃，使活泼
synergy: (协同作用产生的)增效作用，两者协同作用的效果大于各自效果之和
mimic: 模仿
calamitous: 引起灾难的;灾难性的
extirpate: 根除，彻底消灭
emblematic: 象征的，象征性的
disconcerting: 令人仓皇失措的;令人窘迫的
tactful: 处事巧妙的，得体的
vulgarity: 庸俗，粗俗;粗野
insular: 思想狭隘的
histrionic: 演戏似的;极为夸张的，矫揉造作的
taint: 玷污，败坏(名誉、道德等);使受不良影响
circumscribe: 限制，约束
boon: 有益的事物
spiral: 螺旋形行进;盘旋上升或下降
truism: 自明之理;不言而喻的道理;老生常谈
predate: 在日期上早于，比......更早出现或发生
affinity: 喜爱，认同; 相似性，联系
veracity: 真实，真实性
partisan: 狂热的支持者; 偏见的，偏袒的
square: 使符合，使一致
slur: 诽谤，诋毁
facilitate: 促进，使容易，使便利
ad hoc: 专门的，临时的，(为某一目的)特别成立的
detritus: 残渣，屑粒
bookish: 书呆子气的，学究式的
transient: 短暂的，转瞬即逝的
centerpiece: 占中心地位的事物;最引人注目的事物
impalpable: 难以理解的，难以捉摸的
