vivacity: 活力，富有活力
dwindle: 逐渐变小，缩小;减少
relish: 享受
scads: 大量，许多
clog: 阻塞，堵住
conscientious: 认真负责的;勤勤恳恳的
nullify: 抵消，使无效，使失效
impute: 归罪于，归咎于;归因于
alacrity: (答应他人时的)欣然，热情，爽快
not least: 尤其是
affliction: 令人痛苦的事物
monotonous: 单调的，乏味的
thriller: 惊险小说，惊悚片，悬疑片
thrilling: 令人兴奋的，激动人心的
causality: 因果关系，因果性
grumble: 抱怨;发牢骚
derivative: 老套的，没有新意的
supersede: 替代，取代
yield: 产生，带来; (在力量、重压等下)屈曲;倒塌;垮掉
averse to: 厌恶的;反感的;不愿意的
invaluable: 非常宝贵的;极为贵重的，无价的
disown: 否认，否认有......，否认与......有关
genealogy: 家谱，(一系列的)祖先
sidestep: 回避，避开(问题、人等)
antiquated: 过时的，落伍的
vacuous: 没有思想的;愚蠢的
pugnacious: 好斗的;好争吵的
nebulous: 模糊的，不清楚的，模棱两可的
demolish: 完全反驳，彻底否定
dissension: 意见分歧;不和
scold: 痛斥，责骂，叱责
conceive: 想象，设想
unrelenting: 无休止的，毫不放松的，坚定不移的
devolve: (将权力、工作等)移交给下级，下放
impetuous: 急躁的，鲁莽的;冲动的
bagatelle: 琐事;轻松的事
detest: 厌恶，讨厌，憎恶
girth: 围长，(人的)腰围
sentiment: 观点，看法，态度; 情绪
fallacious: 谬误的
fallibility: 容易出错，可能出错
imperative: 至关重要的事，迫在眉睫的事
appurtenance: 附加物，附带的东西
spin: 曲解，歪曲，有利于自己的理解
compulsory: 强制的，强迫的
compulsive: 忍不住的，强迫症一样的
retroactive: (法律等)有追溯力的，溯及既往的
shoulder: 担负，承担(责任或负担)
biotic: 生命的，生物的
overreach oneself: 做力所不能及的事，自不量力
coalesce: 联合;合并
conform: 相似;一致，符合
indolent: 懒惰的
placid: 宁静的，平静的
meteoric: (发展进程)极快的，飞一般的
mien: 外表;样子
wont: [接动词不定式] 倾向于...的，易于...的
unwonted: 不寻常的
