razor-sharp: 极为锋利的;极为犀利的
champion: 捍卫;拥护;支持
iconoclastic: 反传统的，攻击传统的
deem: 认为，视为
predilection: 偏爱，偏好
ample: 大量的，充裕的，丰富的
inexorable: 不容变更的;不可阻挡的
insidious: 阴险的;暗中为害的
genre: (文学或艺术作品等的)体裁，流派
datable: 可确定来自......年代的
awry: 出错的，出岔子的，偏离预期的
pertinacity: 坚持，坚定
exhilarating: 令人高兴的;使人振奋的
heretofore: 直到此时，迄今为止，在这之前
conducive: 有帮助的，有益的
upheaval: 剧变;动荡
burgeon: 迅速生长，繁荣发展
discern: 发现，觉察
transparent: 浅显的，易懂的，明显的
trifling: 微不足道的，无足轻重的
tease (something out): 翻检出，挑出
haphazard: 随意的，毫无条理的
naysay: 拒绝;否认;反对
budding: 正发芽的;发展中的
wild-eyed: 完全不切实际的;想法过激的
boorish: 粗野的，粗俗的
enviable: 令人羡慕的，令人嫉妒的
removed: 远离的; 相去甚远的，截然不同的
comical: 滑稽的，有趣的
astringent: 严厉的，尖刻
punctuate (something with): 打断，使置于......之中
misinterpret: to understand sth./sb. wrongly
pertain: 相关，适用，切题
pertinent: 相关的，适用的，切题的
impertinent: 无礼的，冒昧的; 离题的，不相关的，不关紧要的
panache: 神气十足，潇洒的气质
expedient: 权宜之计;应急的手段
sagacious: 睿智的，聪慧的
forsake: 放弃，抛弃
hindsight: 事后的领悟，事后聪明
pitiful: 可怜的，可悲的，极为差劲的
insuperable: 不可逾越的;不能克服的;抑制不住的
unimpeachable: 无可置疑的，无可指责的
unassuming: 不自大的，谦逊的
nurture: 养育，培育，教养
parallel: 相似的事物，与......相当的事物; 与......相呼应，与......类似
bemuse: 使困惑;使茫然
erode: 逐步毁坏，削弱，损害
employ: 使用，利用
pedigree: 起源，由来
delude: 欺骗;哄骗
modest: 谦虚的，谦逊的，谦恭的; (数量、程度等)有限的，不多的; (住所等)不奢侈的
analogue: 相似物;类似情况
lingering: 拖延的，长久的，迟迟不去的
anthology: (诗、文等的)选集
outright: 全部地;完全地，彻底地
redouble: 加强;大大增加
frenzy: 狂热，疯狂，极度的激动
forbidding: 样子可怕的;令人生畏的
countermand: 撤销，取消(命令等)
placebo: 安慰剂，无效对照剂，医疗实验中用于对照组的没有治疗效果的药物
introspective: 自省的，好自省的
idiosyncrasy: 独特之处，与他人不同的特点
impulse: 冲动;一时的念头
precarious: 不牢靠的，不稳妥的;危险的
salutary: 有益的，有利的
putative: 普遍认为的
inert: 没有活力的; 惰性的
strait: 困境;窘境
mendacity: 撒谎，欺骗
inductive: (推理)归纳的
senescence: 衰老;变老
grandiose: 宏伟的，壮丽的
exigent: 紧急的，急需的

