contented: 满意的，心满意足的
hypercritical: 过分批评的，吹毛求疵的
sound: 完好的，完整的，无损伤的; 坚实的，稳固的，可靠的; 合理的，明智的
specious: 似是而非的，欺骗性的
compound: 使恶化，加剧
dynamism: 富有活力
reparation: v
unmoved: 无动于衷的，不为所动的
hefty: 数量巨大的，可观的
alarmist: 危言耸听的
confound: 使困惑，使不解; 反驳，证明......是错的
be confounded with: 混淆，弄混，混为一谈
preside over: 掌管，领导，负责
deflate: 减轻，减弱(情绪等); 反驳;贬低
applaud: 称赞，赞赏
imitable: 可模仿的;值得模仿的
ape: 模仿
convoluted: 错综复杂的
dampen: 减轻，减弱
disparage: 贬低，轻视
irreverent: 不敬的
dilettante: 粗浅的爱好者，浅尝辄止的人
exorbitant: (费用)过高的，高得离谱的
perspicacity: 富有洞察力，睿智，精辟
rile: 激怒，使恼火
serviceable: 可供使用的
unperturbed: 镇定的，不受扰乱的
profligacy: 挥霍，浪费
unconscionable: 错误的，不合理的
deaden: 减弱(声音、情绪等)
untoward: 不得体的，不合时宜的
fathom: 理解
ascent: (地位等)提高，上升
qualm: (对自己行为的)顾虑，不安
expatriate: 移居国外
scornful: 蔑视的，嘲笑的
the epitome of: 典型代表，典范
commercialism: 过分重视利润，唯利是图
emotive: 激起强烈感情的，激动人心的
incidental: 次要的，附带的
evince: 显示，表明
extravagant: 奢侈的
sage: 智者，贤人，哲人
certitude: 确信，确定，坚信
indulgence: 沉迷，沉溺
apologist: 辩护者，为......辩护的人
escapist: 逃避现实的
morph: 变化，使发生变化
outdo: 胜过，超过，比......更成功
belligerence: 好斗，好战
demographic: 人又学的
rife: (尤指坏事)普遍的，盛行的
atrocious: 极为恶劣的，极为糟糕的
soft-pedal: 淡化，轻描淡写
absolve: 免除......的责任，宣布......无罪
abased: 谦卑的，卑躬屈膝的
buttress: 支持，证实，加强
signify: 表明，说明
solidify: 强化，加强
frustrate: 挫败，阻止
synopsis: 剧情梗概
acute: (问题等)严重的，剧烈的
realm: 领域;范围
advent: 出现，到来
in the midst of: 在......之中
albeit: 尽管，即使
derisive: 嘲笑的，鄙视的，讥讽的
