somnolent: 瞌睡的，昏昏欲睡的
stymie: 妨碍，阻碍
forestall: 预先阻止，先发制人
chic: 时髦的
doctrinaire: 教条主义者，不顾实际情况空谈理论的人
feign: 假装
badger: 烦扰，纠缠不休，反复提问题或要求
acquiesce: 默认;默许
panacea: 万灵药，万能的解决办法
overwrought: 过度激动的;过度兴奋的;过于紧张的
peddle: 宣扬，散播
galvanize: 刺激，刺激某人采取行动，使震惊
impede: 妨碍，阻碍;阻止
anthropomorphic: 被赋予人性的，拟人的
sonorous: 声音浑厚的，隆隆作响的
decided: 毫无疑问的，显然的
nepotistic: 偏袒亲属的;任人唯亲的
cantankerous: 坏脾气的;爱争吵的;爱唱反调的
animadversion: 批评;谴责，责备
empirical: 实证的，以观察或实验为依据的
provision: 条文，条款，规定
obviate: 消除(需求或困难)，使不再需要
resurgence: 复活;复苏
exuberance: 热情洋溢，兴高采烈
aggrieved: 愤愤不平的，感到受不公正对待的
exploit: 充分利用，充分发挥......的效能
austere: 严厉的，严肃的; 极为朴素的，毫无装饰的
lionize: 把...视作名人，重视，崇拜
stipulate: 规定;(作为条件)讲定，约定
reminiscent: 让人回想起......的
hidebound: 思想偏狭顽固的，迂腐的，古板的
douse: 熄灭
pick up: 增加，加强
curtail: 削减，减少
even-tempered: 脾气温和的，不易发脾气的
waver: 犹豫不决，举棋不定
make the grade: 成功，达到标准
impugn: 质疑，批评
foment: 挑起;激起;煽动
recede: 后退; (情绪、特点等)减弱，(希望等)变得渺茫
euphemism: 委婉的说法;委婉语
obscure: 晦涩的，费解的; 不出名的，不重要的; 隐藏，掩盖，遮住; 使模糊，使难以理解; 掩盖......的重要性，显得比......更重要
ebullient: 兴高采烈的，热情洋溢的
overarching: 全面的;包罗万象的
detract (from): 降低;贬低，使失去价值
preordain: 预先决定;提前注定
ebb: (情绪，特点等)减弱，消退
cook something up: 编造，捏造
middle ground: 中间立场，折中方案
robust: 强有力的; 粗俗的，不文雅的
inflated: (语言等)夸张的，言过其实的，华而不实的
malodorous: 难闻的，恶臭的
endeavor: 努力，尽力;尝试
harrow: 使痛苦，使难过
collegial: 同事的，同行的; 合作的，共同承担义务的
feasible: 可行的，行得通的
make something up: 弥补，补偿; 组成，构成
abhor: 厌恶;憎恶
punctilious: 循规蹈矩的，一丝不苟的
impeccable: 完美的;无可挑剔的
consummate: 造诣极高的;完美的
snub: 冷落，怠慢
conflate: 合并;混合
flummox: 使困惑，难住
sketchy: 粗略的，不详尽的
nester: 筑窠的鸟
porous: 能渗透的;透(气、光等)的
avid: 极为热衷的，酷爱的
dejected: 沮丧的，垂头丧气的，情绪低落的
invective: 痛骂，辱骂，猛烈抨击
restorative: 恢复的;康复的
