circumspect: 谨慎的，小心的
espouse: 支持;拥护;信奉
castigate: 严厉批评
dimension: (事物、问题等的)方面，部分，元素
burlesque: 幽默夸张的模仿
transitory: 短暂的，昙花一现的
allure: 魅力;吸引力;诱惑力
culmination: 顶点;高潮;终点
assuage: 缓和，减轻; 安抚，使平静
allusion: 暗指，影射;间接提到
succumb: 屈服，屈从
loquacious: 多话的，过于健谈的
sectarian: 宗派的，狭隘的，门户之见的
stem: 阻挡;制止，遏止;
stem from: 起源于;源自
ungainly: 笨拙的，笨手笨脚的
cursory: 草草的，仓促的，粗略的
extraneous: 无关的，不重要的
forswear: 承诺放弃
diatribe: 猛烈批评
lurch: 颠簸着行进;蹒跚而行
hew to: 坚持;遵守
articulate: (表达)清楚有力的
surreptitious: 鬼鬼祟祟的，偷偷摸摸的
plethora: 太多，过多;过剩
illustrious: 著名的，杰出的，卓越的
meander: (河流等)蜿蜒;迂回曲折地前进
rehabilitate: 使康复，使复原
adverse: 不利的，有害的
adversity: 逆境，困境，困难
be out to do: 决心做某事，力图做某事
virtue: 美德; 优点，长处
by virtue of: 因为，由于，凭借
profusion: 丰富，充沛，大量
neophyte: 初学者，新手，生手
trite: 陈腐的，老套的
longevity: 长寿
coax: 劝诱;哄劝
concur: 同意，一致;赞同
expiation: 补偿;赎罪
presuppose: 以...为先决条件
vitiate: 损害(......的质量或效果)，破坏，削弱
deleterious: 有害的
contagious: (情绪等)有感染力的的，会蔓延开的
parody: 幽默夸张的模仿作品
backhanded: 间接的;转弯抹角的
invidious: 引人不满的，引人反感的，招人嫉妒的
irk: 使厌烦;使恼火
beguile: 欺骗，诱骗
rant: 大声责骂;痛斥
big-time: 顶级的，一流的
meretricious: 华而不实的;俗艳的
slippery: 难以定义的，意思难以捉摸的
disquisition: 专题论文;专题讨论
estrange: 使疏远;离间
crumble: 崩溃，瓦解;消失
demise: 死亡，灭亡，终止
puerile: 幼稚的，孩子气的;愚蠢的
intangible: 不易捉摸的;难以理解的
mawkish: 极为多愁善感的;感情丰富到令人作呕的
insatiable: 无法满足的;贪得无厌的
admonish: 警告，告诫，责备
brook: [用于否定句] 容忍，忍受;容许
ecumenical: 世界范围的;普遍的
ascetic: 极为节制的;禁欲的;苦行僧般的
antecedent: 先前的，在......之前的
pedagogical: 教学的;教育学的
diffident: 不自信的，胆怯的
sterling: 极好的，极富价值的
preponderance: (数量、重要性等方面的)优势;多数
self-flattery: 自我夸耀，自吹自擂;自我粉饰
abate: 减少，减弱，减轻
cordial: 热情的，友好的
whereby: [关系副词] 靠那个;凭借那个，借以
